Muniz = A
Alessandra = B
Ricardo = C
Katia = D
Edson = E
Clelia = F
Tieme = G
Katia Gomes = H
Silvia = I
Adriana = J
Cesar = K
FÃ¡tima = L
Erika = M
Vera = N
Simone = O
Mauricio = P
Eduardo = Q
Lilian = R
Renato = S
Samantha = T
Rodrigo = U
Dom = V
Anna Cris = W
Lais = X
Waldemar = Y
Celso = Z
Katia Lima = 0
Gigi = 1
Dr. Klaus = 2
Dr. Hanz = 3
Dr. Alberto = 4
Dr. Eduardo = 5
Dr. Nicopai = 6
Dr. Erminio = 7
Dr. Frederico = 8
Dr. Kalito = 9
Passe = ,
Passe Preferencial = .

Para Retroceder utilize o SHIFT com qualquer uma das teclas acima